XXXXXXX
X     X
X XX  X
X XX  X
X FXA X
XXXXXXX